###########################
##...#....#################
#....#....#################
#....#....................#
#....#.........############
#.........................#
#..............############
#..............############
##########................#
#.........................#
#................##########
#.........#################
#.........#################
#.........................#
###########################