###########################
##........................#
#.........................#
#.........................#
#..............############
#.........................#
#..............############
#..............############
##########................#
#.........................#
#................##########
#.........................#
#.........................#
#.........................#
###########################