########################################
#......................................#
#......###############.##############.##
#......###############.##############.##
#......###############.##############.##
#......###############................##
######.#########################.#######
######................................##
######.#################################
######.##############.................##
######.##############.########........##
######.##############.########........##
######.##############.########........##
#......................................#
#..####.##########.##########.########.#
#..####.##########.##########.########.#
#..####.##########.##########.########.#
#..####............##########..........#
#..########.############################
#.#########.############################
#......................................#
########################################