########################################
#......................................#
#......###############.##############.##
#......###############.##############.##
#......###############.##############.##
#......###############................##
#.####.#########################.#######
#.....................................##
##.###.##.###.##########################
##.###.##.###.#######.................##
##.###.##.###.#######.########........##
##.###........#######.########........##
##.###.######.#######.########........##
#......................................#
#..####.####.#####.#####.####.#.######.#
#.......####.#####.####..####.#......#.#
#..####.####.#####.###..#####.######.#.#
#..####............###.######..........#
#..########.############################
#.#########.############################
#......................................#
########################################